## MAP BEGIN ##
0 0 0 0 0 0 0 0 0 0 0 0 0 0 0 0 0 0 0 0 0
0 0 0 0 0 0 0 0 0 0 0 0 0 0 0 0 0 0 0 0 0
0 0 0 0 0 0 0 2 2 2 0 2 2 2 2 2 0 0 0 0 0
S 2 0 2 2 2 2 2 0 2 0 2 0 0 0 2 2 2 2 0 0
0 2 2 2 0 0 0 0 0 2 0 2 0 0 0 0 0 0 2 2 0
0 0 0 0 0 0 0 0 0 2 0 2 0 0 0 0 0 0 0 2 0
0 0 0 0 0 0 0 0 0 2 0 2 0 0 0 0 0 0 0 2 0
0 0 0 0 0 0 0 0 0 2 2 2 0 0 0 0 0 0 0 2 0
0 0 0 0 0 0 0 0 0 0 0 0 0 0 0 0 0 0 0 E 0
## MAP END ##
## DATA BEGIN ##
## DATA END ##